╔═════════════════════╗
║.....................║
║.....................║
║.....................║
║.....................║
║..............M...┌─┐║
║......M...........┃$│║
║..................└─┘║
║.....................╚═══════════════╕
║.....................................┇
║.....................╔═══════════════╛
║.....................║
║.....................║
╚═════════════════════╝